NO     ./textures/cobblestone.xpm
SO    ./textures/mossy_stone_bricks.xpm
WE     ./textures/mossy_cobblestone.xpm
EA    ./textures/stone_bricks.xpm
F   0,102,0
     C     51,153,255

        1111111111111111111111111     1111111
        1000000000110000000000001     1000001
        1011000001110000000000001     1000001
        1001000000T00000000000001     1111111
111111111011000001110000000000001
100000000011000001110111111111111
1111011111111101110000000001
111101111  11111011001010101
1100000111110101111100001001
10000000R00000000000000000011
100000000000N0000110100000001
11000001110101011110111110001
11110111 1110101 100111000001
11111111 1111111 111111111111

